35 20
#############                      
#...........#    ######## <------> 
#...s...s...######......# !      | 
#......s................# !      |  
#...........######......# !      | 
#.....s.....#    #......# !      | 
#...H....H..#    #..s...# !      | 
#...........#    #......# !      | 
#####..######    ###..### \______/          
    #.m#           #..#            
    #.h#           #..#   <------> 
    #.w#          ##..##  !      | 
  ###..####      #......# !X     | 
  #..p....#      #......# !X     | 
  #.......#      #......# !X     | 
  #.......#      #......# !X     | 
  #.......#      #......# !X     | 
  #.......#      #......# \______/        
  #.......#      #......#          
  #########       ######           